Amazon Elastic MapReduce (elasticmapreduce) : https://docs.aws.amazon.com/de_de/emr/latest/APIReference/API_DescribeCluster.html
- elasticmapreduce:AddInstanceFleet 	Adds an instance fleet to a running cluster.	???	Global Conditions
- elasticmapreduce:AddInstanceGroups 	AddInstanceGroups adds an instance group to a running cluster.	???	Global Conditions
- elasticmapreduce:AddJobFlowSteps 	AddJobFlowSteps adds new steps to a running job flow.	???	Global Conditions
- elasticmapreduce:AddTags 	Adds tags to an Amazon EMR resource.	???	Global Conditions
- elasticmapreduce:CancelSteps 	Cancels a pending step or steps in a running cluster.	???	Global Conditions
- elasticmapreduce:CreateSecurityConfiguration	Creates a security configuration, which is stored in the service and can be specified when a cluster is created.	???	Global Conditions
- elasticmapreduce:DeleteSecurityConfiguration	Deletes a security configuration.	???	Global Conditions
elasticmapreduce:DescribeCluster 	Provides cluster-level details including status, hardware and software configuration, VPC settings, and so on.	???	Global Conditions
elasticmapreduce:DescribeJobFlows 	This API is deprecated and will eventually be removed.	???	Global Conditions
elasticmapreduce:DescribeSecurityConfiguration	Provides the details of a security configuration by returning the configuration JSON.	???	Global Conditions
elasticmapreduce:DescribeStep 	Provides more detail about the cluster step.	???	Global Conditions
elasticmapreduce:ListBootstrapActions 	Provides information about the bootstrap actions associated with a cluster.	???	Global Conditions
elasticmapreduce:ListClusters 	Provides the status of all clusters visible to this AWS account.	???	Global Conditions
elasticmapreduce:ListInstanceFleets 	Lists all available details about the instance fleets in a cluster.	???	Global Conditions
elasticmapreduce:ListInstanceGroups 	Provides all available details about the instance groups in a cluster.	???	Global Conditions
elasticmapreduce:ListInstances 	Provides information about the cluster instances that Amazon EMR provisions on behalf of a user when it creates the cluster.	???	Global Conditions
elasticmapreduce:ListSecurityConfigurations	Lists all the security configurations visible to this account, providing their creation dates and times, and their names.	???	Global Conditions
elasticmapreduce:ListSteps 	Provides a list of steps for the cluster.	???	Global Conditions
- elasticmapreduce:ModifyInstanceFleet 	Modifies the target On-Demand and target Spot capacities for the instance fleet with the specified InstanceFleetID within the cluster specified using ClusterID.	???	Global Conditions
- elasticmapreduce:ModifyInstanceGroups 	ModifyInstanceGroups modifies the number of nodes and configuration settings of an instance group.	???	Global Conditions
- elasticmapreduce:PutAutoScalingPolicy 	Creates or updates an automatic scaling policy for a core instance group or task instance group in an Amazon EMR cluster.	???	Global Conditions
- elasticmapreduce:RemoveAutoScalingPolicy	Removes an automatic scaling policy from a specified instance group within an EMR cluster.	???	Global Conditions
- elasticmapreduce:RemoveTags 	Removes tags from an Amazon EMR resource.	???	Global Conditions
- elasticmapreduce:RunJobFlow 	RunJobFlow creates and starts running a new job flow.	???	Global Conditions
- elasticmapreduce:SetTerminationProtection 	SetTerminationProtection locks a job flow so the Amazon EC2 instances in the cluster cannot be terminated by user intervention, an API call, or in the event of a job-flow error.	???	Global Conditions
- elasticmapreduce:SetVisibleToAllUsers 	Sets whether all AWS Identity and Access Management (IAM) users under your account can access the specified job flows.	???	Global Conditions
- elasticmapreduce:TerminateJobFlows 	TerminateJobFlows shuts a list of job flows down.	???	Global Conditions
